get a copy of the agenda - dostać kopię agendy/programu
would you mind? - czy mógłbyś/zechce pan
not at all - ani trochę/wcale nie
let's get going - kontynuujmy
first of all - po pierwsze/przede wszystkim
attend at short notice - uczestniczyć w krótki zebraniu
as you know - jak wiesz
the objective of this meeting is - celem tego spotkania jest
capital works - nakłady kapitałowe
discuss a proposal - omówić propozycję
urgent building work - pilne prace budowlane
southside plant - południowa strona budynku
run it as a formal meeting - prowadzić je, jako formalne spotkanie
without further notice - bez uprzedniego powiadomienia
be convinced - być przekonanym
be as urgent as - być tak pilne jak
sum up - podsumować/zreasumować
a long term plan for a major profit - długoterminowy plan osiagnięcia dużego zysku
if there's no more discussion - jeśli nie ma więcej dyskusji
put it to a vote - poddać to głosowaniu
all these in favour - wszystko to na rzecz

the building is practically falling down - budynek się praktycznie zawala
as i was saying - jak mówiłem
as far as - tak daleko jak/aż do/o ile
be concerned - być zaniepokojonym/obawiać się
a question of safety - kwestia bezpieczeństwa
go ahead - posunąć się naprzód/iść przodem
get hurt - zranić się
a serious risk of accident - poważne ryzyko wypadku
are you implying? - sugerujesz, że
have done something earlier - zrobić coś wcześniej