rzeczowniki:
advocate - obrońca
annulment - anulowanie/unieważnienie
apostle/disciple - apostoł
catechism - katechizm/katecheza
commandment - przykazanie
confirmation - bierzmowanie
counselling - doradztwo
devotion - oddanie się/pobożność/religijność
diocese - diecezja
dwelling - mieszkanie/dom
essence - esencja/istota/sedno
follower - wyznawca
indwelling - napełnianie
inquiry - zapytanie/prośba
marrying - poślubianie
mercy - łaska/litość/miłosierdzie
missionary - misjonarz
nullity - nieważność
resurrection - rycerz
retreat - rekolekcje
monstrance - monstrancja
parish - parafia
peace - pokój
Pentecost - Zesłanie Ducha Świętego/Zielone Świąki
resurrection - zmartwychwstanie
rosary - różaniec
scripture - świeta księa/pismo
solemnity - powaga/podniosłość
stewardship - zarządzanie/szafarstwo
vicar - pastor/wikariusz
worship - kult/cześć/uwielbienie

czasowniki:
dwell - zamieszkiwać/przebywać
fulfill - spełniać
rejoice - radować się
remark - spostrzegać/zauważać
remarry - ponownie się żenić
reoccur - powtarzać się/powracać
serve - służyć
strive - usiłować/starać się
transform - przekształcać

przymiotniki:
baptized - ochrzczony
cherished - ukochany/ulubiony
corporeal - cielesny/fizyczny/materialny
divine - boski/boży/cudowny
everlasting - wieczny
faithful - wierny/dokładny/niezawodny
household - gospodarski
joyful - szczęśliwy/radosny
Marian - maryjny
parochial - parafialny
spiritual - duchowy/religijny
upcoming - zbliżający się/nadchodzący
welcoming - serdeczny/ciepły/miły

przysłówki:
closely - pilnie/uważnie/szczegółowo/dokładnie
spontaneously - żywiołowo/spontanicznie

wyrażenia:
anointing of the sick - namaszczenie chorych
as I see it - według mnie
be baptized - przyjąć chrzest
be confirmed - być bierzmowanym
be/feel honored - być zaszczyconym
call upon sb - wzywać kogoś/prosić kogoś o coś
minister to sb - służyć komuś
rise up - unosić się
send sb in - posyłać kogoś
set the world on fire - zadziwić wszystkich
so that - po to, aby
speak of sb - rozmawiać/wspomnieć o czymś
strive to do sth - usiłować coś zrobić
yet - ale