rzeczowniki:
adobe - cegła suszona na słońcu
backdrop - horyzont/tło
blockbuster - bestseller
booze - alkohol/gorzała
bucking - zrzucanie/przeciwstawianie się/szarpanie
byway - skrót/boczna droga/peryferie
cactus - kaktus
campfire - ognisko 
cave - jaskinia
concoction - mieszanka/mieszanina/mikstura
convertible - kabriolet
cruise - rejs
dam - tama/zapora
dark - zmrok/zmierzch
gunfighter - osoba sprawnie posługująca się bronią palną w walce
handicraft - rękodzieło/rzemiosło
harvest - plony/zbiory/żniwa
horseshoe - podkowa
hub - centrum/środek/węzeł komunikacyjny/punkt przesiadkowy
itinerary - plan podróży/przewodnik
lazing - próżnowanie/leniuchowanie
mantra - mantra
meandering - włóczęga/wałęsanie się
miner - górnik
playground - plac zabaw
pueblo - małe miasteczko
rafting - spływ pontonem górską rzeką
rapids - progi rzeczne/wodospad spadający z kilku stopni skalnych
rim - brzeg/krawędź
sage - szałwia
scoop - gałka/łyżka
shack - buda/szopa/chałupa/chata
sing-along - wspólne śpiewanie/wieczór piosenki
stargazing - amatorska astronomia
succulent - sukulent (roślina gromadząca wodę)
sunset - zachód słońca
vacationing - spędzanie wakacji
vortex - wir
wanderings - wędrówka/tułaczka
winemaker - osoba robiąca wino
winery - winiarnia
wreath - wianek/wieniec

czasowniki:
dump - wyrzucać/rzucić
paddle - wiosłować/brodzić w wodzie
plummet - runąć/spadać/obniżać się
retreat - wycofywać się/ustępować
witness - być świadkiem/doświadczać

przymiotniki:
breeding - hodowlany/lęgowy
crumbling - popadający w ruinę/niszczejący/upadający
dilapidated - podupadły/walący się/zniszczony
distant - daleki/odległy
diverse - różnorodny/rozmaity
downright - jawny/kategoryczny/stanowczy/szczery/otwarty
enchanted - oczarowany/zauroczony/zaczarowany
epic - epicki
five-star - pięciogwiazdkowy
flustered - zgubiony/skołowany
insider - poufny
interstate - międzystanowy
jagged - postrzępiony/poszarpany/wyszczerbiony/ostry
limitless - bezkresny/niezmierzony
lit - oświetlony/szałowy/bezbłędny
luscious - słodki/soczysty/ckliwy/pociągający
memorable - pamiętny/godny zapamiętania/zapadający w pamięć
offbeat - niekonwencjonalny/nietypowy/nieregularny
outdoorsy - lubiący przebywać na świeżym powietrzu
quirky - dziwny/ekscentryczny
rural - wiejski/rolniczy
scented - pachnący/perfumowany
seasonal - sezonowy
shady - ciemny/zaciemniony/podejrzany/nieczysty
snow-capped - ośnieżony/pokryty śniegiem
stomach-churning - powodujący mdłości
sustainable - długofalowy/trwały
tangy - cierpki/ostry/orzeźwiający
tricky - trudny/podchwytliwy/podstępny/chytry
vintage - szlachetny/klasyczny/stylowy/z poprzedniej epoki
wacky - głupi/stuknięty/zwariowany

przysłówki:
predominantly - głównie/w głównej mierze/przeważnie

wyrażenia:
after dark - po zmroku
and yet - a jednak
catch a buzz - wstawić się (być lekko pijanym)
check out - sprwadzać
cuts of beef - kawałki wołowiny
downright - zupełnie/wręcz
dress up as sb - przebrać się za kogoś
fast-forward - przewijać do przodu
figure out - zrozumieć coś/rozwiązać jakiś problem/wymyślić coś/wykombinować coś
geronimo! - z drogi!
hands down - z łatwością/bez dwóch zdań/z kretesem
hark back - wspominać
hot spring - gorące źródło
hunt for sth - poszukiwać czegoś/polować na coś
in search of sth - w poszukiwaniu czegoś
jagged peak - ostry, poszarpany szczyt
lawn chair - krzesło ogrodowe/leżak
leave out - pominąć coś/opuścić coś
low road - droga występku
narrow sth down - zawęzić coś/zawężać coś
pet-friendly - przyjazny/przystosowany dla zwierząt
short drive - krótka przejażdżka
take the high road - postępować zgodnie z przekonaniami moralnymi
team up - dołączyć do zespołu/połaczyć siły/współpracować
team up with sb - stworzyć z kimś zespół/zacząć z kimś współpracować