rzeczowniki:
measles - odra

czasowniki:
criticize - krytykować/skrytykować
persuade - namawiać/przekonywać/perswadować
recover - dochodzić do siebie/powracać do zdrowia/odzyskiwać/wychodzić z krezysu

przymiotniki:
glad - zadowolony/wdzięczny
naughty - nieposłuszny/niesforny/niegrzeczny

wyrażenia:
be getting at sth - zmierzać do czegoś/insynuować coś
come across sth - natknąć się na coś
come along - pośpiesz się
come down with sth - zachorować na coś
come off - wyjść/udać się/wypaść
come into - dziedziczyć w spadku
come out in sth - dostawać czegoś, np. wysypki
come through - nadchodzić
come to - odzyskać przytomność
come up against sth - napotkać na jakieś trudności/zmagać się z jakimiś problemami
come up to sth - podejść do kogoś/zbliżyć się
come up with - znaleźć coś/wymyślić coś
cut back/cut down on - redukować/ograniczać
cut in - wcinać się/zajachać drogę
cut off - odcinać/wyłączać/przerywać
cut out - wycinać/zaprzestać/kończyć/usuwać/pomijać
get across - przekazywać/wyjasniać
get at sb - naskoczyć na kogoś/skrytykować/zastraszać
get at sth - sięgać po coś/dowiadywać się prawdy o czymś/sugerować/implikować
get away with sth - ujść z czymś na sucho/wymigać się od czegoś
get by - radzić sobie finansowo/dawać radę
get by on sth - przeżyć na czymś
get down to - zabrać się do czegoś
get on - wsiadać/odnosić sukces/radzić sobie/dawać sobie radę
get out of - wyjeżdzać skądś/opuścić jakieś miejsce/uniknąć czegoś/wymigać się od czegoś
get over sth - wyzdrowieć/dochodzć do siebie/otrząsnąc się/radzić sobie/pogodzić się z czymś/dawać sobie z czymś spokój/odpuszczać coś sobie
get round to sth - zabrać sie do czegoś, co było długo odkładane
get round sb - przekonać/przekabacić kogoś
get through sth - wykonywać coś/przebrnąć przez coś/przetrwać coś/radzić sobie z czymś
get through to sth - dotrzeć do czegoś
get up to sth - przeskrobać coś/robić coś, czego inni nie pochwalają
live on sth - żyć za określoną sumę