rzeczowniki:
novelty - nowość/atrakcja/błyskotka
profitability - zyskowność/rentowność/dochodowość/opłacalność
scrutiny - szczegółowe badanie/analiza/przepatrywanie się/obserwacja/nadzór

czasowniki:
commence - rozpoczynać/rozpocząć/wszczynać/wszczać/rozpocząć się
cover - przykryć/zasłonić/obejmować/przemierzać/zajmować/relacjonować/przedstawiać
differentiate - odróżniać/rozróżniać/wyróżniać się
greet - witać/przywitać/powitać/przywitać się
scrutinize - szczegółowo badać/analizować/obserwować

przymiotniki:
noteworthy - godny uwagi/interesujący
thorough - gruntowny/dokładny/skrupulatny/skończony/całkowity

przysłówki:
further - dalej
further on - dalej do przodu

wyrażenia:
break sth down - rozłożyć coś na części
bring sb up to speed - dostarczyć komuś najświeższe informacje na dany temat/wtajemniczyć/poinformować kogoś
draw attention to sth - zwrócić uwagę na coś
intend to do sth - zamierzać coś zrobić
lay emphasis on sth - kłaść nacisk na coś
lead to sth - prowadzić do czegoś
move on to sth - przechodzić do czegoś
proceed to sth - przechodzić do czegoś/dojść do czegoś
raise a subject - podjąć temat
regarding - jeśli chodzi o/co się tyczy/odnośnie/względem/w zakresie
revolve around sth - koncentrować się wokoł czegoś/dotyczyć czegoś/kręcić się wokół czegoś
take the opportuinity - korzystać ze sposobności
turn to sth - skierować się ku czemuś/zwrócić się w stronę czegoś/spojrzeć na stronę