rzeczoniwki:
air traffic controller - kontroller lotów
aisle - przejście/nawa/alejka
bargain - okazja/dobry interes/układ
bed and breakfast - zakwaterowanie ze śniadaniem
boarding card/pass - karta pokładowa
boot - bagażnik
cancelled flight - odwołany lot
cheque/check - czek
cockpit - kapina pilota
crowd - tłum/paczka znajomych
deck - pokład/piętro
departure lounge/hall - hala odlotów
detour/diversion - objazd/zmiana kierunku
dock - dok/nabrzeże
double-decker - autobus piętrowy
excursion - wycieczka/wyprawa
family room - pokój rodzinny/duży pokój hotelowy
freight/goods train - pociąg towarowy
fishing boat - łódź rybacka
fligh attendant/stewardess - stewardessa
foreign currency - dewizy
full boad - pełne wyżywienie
guided tour - zwiedzanie z przewodnikiem
half-board - zakwaterowanie z częściowym wyżywieniem
harbour/port - port/przystań
hijack - porwanie
insurance - ubezpieczenie
jet - odrzutowiec
jet lag - zaburzenie rytmu dobowego wynikającego z różnicy czasu
lorry - ciężarówka
lost luggage - zgubiony bagaż
mechanic - mechanik
passenger train - pociąg pasażerski
plane crash - katastrofa lotnicza
puncture - przebita opona/guma/kapeć
reservation - zastrzeżenie
restaurant car - wagon restauracyjny
road accident - wypadek drogowy
runway - pas startowy
seasickness - choroba morska
seaside - nad morzem/wybrzeże/tereny nadmorskie
shipwreck - wrak statku/katastrofa morska
shoulder bag - torbę na ramię
sleeping-car - wagon sypialny
sport car - samochoód sportowy
steering wheel - kierownica
subway/underground - metro
suitcase/case - walizka
taxi rank - postój taksówek
terrace taras
ticket inspector - kontroler biletów
tour operator - biuro podróży/organizator wycieczek
train journey - podróż pociągiem
travel/motion sickness - choroba lokomocyjna
travel agency - biuro podróży
voyage - rejs
wing - skrzydło

czasowniki:
derail - wykoleić się

przymiotniki:
all-inclusive - łączny koszt/wliczający wszystkie opłaty
duty-free - wolny od cła
en-suite - z przyległą łazienką
own - własny
self-catering - z wyżywieniem we własnym zakresie
twin - podwójny

wyrażenia:
bits and pieces - drobiazgi
eager for sth - spragniony czegoś
on the day of the sale - w dniu sprzedaży
so that - żeby/po to/aby