rzeczowniki:
acceptance - akceptacja/zaakceptowanie/aprobata/zgoda
adherence - przestrzeganie/przyleganie/przywieranie/przywiązanie/wierność
adherent - stronnik/zwolennik/członek
advance - osiągnięcie/rozwój/postęp/zaliczka/zadatek/zwyżka/natarcie
advances - zabiegi/zaloty
assumption - przypuszczenie/założenie/objęcie/przejęcie/wniebowzięcie
awareness - świadomość/wiedza/znajomość
bigotry - dewocja/fanatyzm
consciousness - przytomność/świadomość
conversion - nawrócenie
convert - konwertyta
credence - wiara
exploitation - wyzysk
fanatic - fanatyk/entuzjasta
fanaticism - fanatyzm
fool - głupek/dureń/błazen
historian - historyk
radical - radykła/radykalista
radicalism - radykalizm
feminism - feminizm
movement - ruch/manewr/zmiana
origin - źrodło/pochodzenie
philosophy - filozofia/dywiza/zasada
physicist - fizyk
pinch - szczypta
postulate - założenie/postulat
poverty - bieda/ubóstwo
principle - zsada/reguł/prawo
reaction - reakcja/odruch/odziaływanie/przemiana
reactionary - reakcjonista (przciwnik zmian społecznych i politycznych)
relationship - relacja/stosunek/związek/pokrewieństwo
religion - religia
schoolboy - uczeń
scholar - erudyta/badacz/uczeń/stypendysta/student
stranger - obcy/nieznajomy
tenet - dogmat/doktryna/zasada
universe - wszechświat
variety - różnorodność/urozmaicenie/wybór
weapon - broń

czasowniki:
abolish - uchylać/unieważniać/likwidować/obalać/znosić/usuwać/kasować
achieve - osiągać/zdobywać/zrealizować/ukończyć/dokonywać/spełniać/dobrze sobie radzić/mieć sukcesy
ascribe - przypisywać
convert - przerabiać/modyfikować/przekszałtać się/zaadoptować/nawracać/zmienić
desire - pragnąć/zyczy sobie/pożądać
eradicate - wykorzeniać/wyplewić/wypleniać/zwalczać/pozbywać się
introduce - przedstawiać/wprowadzać/sprowadzać/wnosić/zapoznawać/zaznajamiać
lend - pozyczać (coś komuś/o banku)
pinch - szczypać/uściskać/uwierać/cisnąć/aresztować/podwędzić/zakosić
postulate - zakładać/twierdzić/postulować/domagać się
seek - ubiegać się o/dążyć do/zabiegać o/szukać/poszukiwać
stem - pochodzić/wynikać/pojawiać się

przymiotniki:
anxious - zaniepokojony/zatroskany/pragący/żądny
believable - wiarygodny/realistycznie przestawiony
bigoted - fanatyczny/świętoszkowaty
contemporary - współczesny/ówczesny
credulous - łatwowierny/naiwny
credible - wiarygodny
disapproving - krzywy/wyrażający dezaprobatę
fanatical - fanatyczny/obsesyjny
implausible - nieprzekonujący/nieprawdopodobny/mało prawdopodobny
inclined - pochyły/usposobiony/skłonny
incredulous - niedowierzający/sceptyczny/nieufny
ingenuous - naiwny/prostoduszny
plausible - prawdopodobny/wiarygodny/przekonujący
primary - główny/podstawowy/początkowy/elementarny/pierwotny
radical - drastyczny/radykalny/zasadniczy/dobry/udany
reactionary - konserwatywny/przeciwdziałający zmianom
self-professed - samo-zadeklarowany
theoretical - teoretyczny/akademicki
unquestioning - bezwzględny/ślepy

przysłówki:
fairly - raczej/dość/dosyć/całkiem/całkowicie/zupełnie
informally - nieformalnie/nieoficjalnie/swobodnie/na gruncie towarzyskim poufale
totally - całkowicie/zupełnie/totalnie
universally - powszechnie/ogólnie

wyrażenia:
a likely story - uważaj bo ci uwierzę/niezła historyjka (ironicznie)
adhere to sth - stosować się do czegoś/trzymać się czegoś
attribute sth to sb - przypisywać coś komuś (np. autorstwo)
be inclined to do sth - mieć skłonność do robienia czegoś
benefit of the doubt - przywilej wątpliwości na korzyść oskrażonego
convert to sth - nawrócić się na coś (np. na Chrześcijaństwo)/przejść na coś
derive from sth - pochodzić z/od czegoś
get rid of sth - pozbyć się czegoś
give credence to sth - dawać czemuś wiarę
I don't buy it - nie kupuję tego (nie wierzę w to)
lend credence to sth - uprawdopodobnić coś/uwiarygodnić coś/nadać czemuś wiarygodność
pull the other one/it's got bell on - bujać to my, ale nie nas
put sth forward - proponować coś/przestawiać coś do przodu/przedstawiać coś/poruszać jakiś temat
sb wasn't born yesterday - ktoś nie urodził się wczoraj/nie jest taki naiwny
set of sth - zestaw czegoś
social rights - prawa socjalne
stem from sth - wynikać z czegoś
take sth with a pinch of salt - podchodzić do czegoś z niedowierzaniem/traktować cośz przymrużeniem oka/przyjąć coś scptycznie/z rezerwą
usher in - zapoczątkować (coś)