rzeczowniki:
brake - hamulec
bypass/ring road - obwodnica
crossroads/junction - skrzyżowanie dróg
direction - kierunek
diversion - objazd
drink-driving - jazda pod wpływem alkoholu
driving licence - prawo jazdy
dual carriageway - droga szybkiego ruchu/dwujezdniowa
lay-by - zatoczka
motorway/highway/freeway - autostrada
pile-up - karambol
puncture - guma/kapeć
rear window - tylna szyba
regulations - przepisy
reverse - wsteczny
road hog - pirat drogowy
roundabout/traffic circle - rondo
rush hour/peak hour - godzina szczytu
side road - boczna droga
signs - znaki drogowe
skid - poślizg
slip road - droga wjazdowa/wyjazdowa z autostrady
speed limit - ograniczenie prędkości
ticket - mandat
toll road - płatna droga
traffic - ruch
traffic jam/tailback/gridlock/hold-up - korek uliczny
verge - pobocze

czasowniki:
indicate - zasygnalizować
go pass - minąć
overtake - wyprzedzać
pull over - zjechać na bok/zatrzymać się na poboczu
reverse/go backwards - cofać
swerve - gwałtownie skręcić
turn - skręcać

wyrażenia:
change the wheel - zmieniać koło
don't observe traffic signs - nie przestrzegać znaków drogowych
find a diversion - znaleźć objazd
get stuck in a traffic jam/held-up - utknąć w korku
have a puncture - mieć flaka/złapać gumę
on my way home - w drodze to domu
over long distances - na długich dystansach