rzeczowniki:
accountability - odpowiedzialność/poczytalność/rozliczalność
governance - kierowanie/zarządzanie
integrity - prawość/uczciwość/nienaruszalność
lawsuit - proces sądowy
prosecution - oskarżenie
whistleblower - informator/demaskator/sygnalista

czasowniki:
allege - zarzucać/pomawiać/powoływać
bribe - dać łapówkę/przekupić
chair - przewodniczyć/prowadzić
compromise - kompromitować/narażać na szwank/ujawniać
legitimise - legitymizować/legalizować/usprawiedliwiać/uzasadniać
serve - słyżyć/obsługiwać

przymiotniki:
accountable - odpowiedzialny/zrozumiały
alleged - rzekomy/przypuszczalny/domniemany
controversial - kontrowersyjny
disreputable - nędzny/niecny/haniebny/mający złą opinię/podejrzany
ethical - etyczny/moralny
fraudulent - oszukańczy/fałszywy/nieuczciwy
fuzzy - rozmyty/niewyraźny/zamazany
hollow - pusty/bezwartościowy
illegal - nielegalny/bezprawny
impartial - bezstronny/obiektywny/sprawiedliwy
incorruptible - nieprzekupny
law-abiding - praworządny
legalised - poświadczony/uwierzytelniony
legitimate - legalny/prawowity/prawy/słuszny
partial - stronniczy
principled - kierujący się zasadami/uzasadniony
reputable - zaszczytny/poważany/szanowany/renomowany
scrupulous - uczciwy/sumienny
unaccountable - niewytłumaczalny/niezrozumiały/nie tłumaczący się
uncontroversial - niekontrowersyjny
underhand - oszukańczy/podstępny
unethical - nieetyczny
unprincipled - bez zasad/pozbawiony skrupułów
unscrupulous - nie mający skrupułów/nie przebierający w środkach
vulnerable - bezbronny/wrażliwy/czuły

przysłówki:
curiously - interesująco/niezwykle/z ciekawością
lawfully - legalnie/zgodnie z prawem

rzeczowniki złożone:
good governance - dobre rządzenie
hollow words - puste słowa
mission statement - hasło przewodnie/myśl przewodnia

czasowniki złożone:
carry sth out - przeprowadzać/realizować/wykonywać coś
come forward - przychodzić z pomocą/zgłaszać się/ujawnić się
communicate - przekazywać/komunikować/porozumiewać się
cut sb off - oddzielić/odseparować kogoś
face up to sth - stawiać czoła czemuś/pogodzić się z czymś
fall into sth - wpaść w coś/rozpocząć coś przypadkowo
get across to sb - dotrzeć do kogoś
get sth across to sb - wywoływać oddźwięk
kick off sth - rozpoczynać/zacząć coś
manage to do sth - dać radę coś zrobić
phase sth out - wycofywać coś stopniowo/etapami/odstawiać coś
set sth out - przedstawiać/wyłożyć coś/określać
shy away from sth - odsunąć się od czegoś/wycofać się z czegoś
turn sb off - odrzucać kogoś
work out - sprawdzać/powieść/udawać się/zrozumieć coś

wyrażenia:
be liable to sth - podlegać czemuś
follow suit - naśladować/iść za przykładem/postąpić tak samo
little by little - stopniowo/po trochu/powoli
mark somebody out as - uczynić kogoś/wyróżniać kogoś jako