rzeczowniki:
accelerator - pedał gazu
bonnet - maska
boot - bagażnik
brake - hamulec
clutch - sprzęgło
connecting flight - lot z przesiadką
cyclist - rowerzysta
dashboard - deska rozdzielcza
day return - bilet ze zniżką przy powrocie tego samego dnia
door handle - klamka
engine - silnik
gear stick/lever - dźwignia zmiany biegów
headlight - przedni reflektor
horn - klakson
motorcyclist - motocylista
nightmare - koszmar
number plate - tablica rejestracyjna
ignition - zapłon/stacyjka
rear-view mirror - 
speedometer - prędkościomierz
steering wheel - kierownica
tyre - opona
wheel - koło
wing/side-view mirror - lusterko boczne
windscreen - przednia szyba
windscreen wiper - przednia wycieraczka

czasowniki:
accelerate/go faster - przyspieszać/jechać szybciej
brake - hamować
drive up - podjechać
get in - wsiadać
get lost - zgubić się
hire - wynająć na krótki okres
steer - prowadzić
stop off - zatrzymać 

przymiotniki:
due - należny/stosowny/planowany
overnight - całonocny
unpleasant - niemiły/nieprzyjemny/niesympatyczny

przysłówki:
gently - delikatnie/łagodnie/uważnie
on the way - po drodze

wyrażenia:
arrive in - przybyć do
at the border - na granicy
avoid skidding - unikać poślizgów
bad driver - słaby/kiepski kierowca
bad road conditions - złe warunki drogowe
because of - z powodu
be meant to do sth - zostać o coś poproszony
be prepared for sth - być na coś przygotowany
cancel sth - anulować/odwołać coś
change gear - zmienić bieg
don't drive too close to the vehicle in front - nie trzymać się zbyt blisko pojazdu z przodu
don't turn up - nie pojawić/zjawić się
drive in the rain - jechać/prowadzić w deszczu
end up on the outskirts - skończyć gdzieś na obrzeżach
get/be held up/be delayed - być opóźnionym
give someone plenty of space - dać komuś mnóstwo miejsca
go over the limit - przekraczać ograniczenie prędkości
have trouble getting to the airport - mieć kłopot z dostaniem się na lotnisko
heavy traffic - duży ruch
hire/rent a car - wynająć samochód
keep to speed limit - przestrzegać ograniczenie prędkości
look at the engine - spojrzeć na silnik
look in the mirror - spojrzeć w lusterko
open the bonnet - otworzyć maskę
open the boot - otworzyć bagażnik
pick sb up - odebrać/podwieźć kogoś
press the horn - nacisnąć klakson
put your foot on the accelerator/brake/clutch - połozyć stopę na gazie/hamulcu/sprzęgle
rather than/instead of/in place of - zamiast/raczej niż/bardziej niż
see at night - widzieć w nocy
store luggage - przechować bagaż
turn a corner - skręcić za rogiem
turn on the headlights - włączyć reflektory
turn on the ignition - przekręcić stacyjkę
turn on the wipers - właczyć wycieraszki
warn someone - ostrzegać kogoś
watch/look out for - uważaj na
without warning - bez ostrzeżenia
