rzeczowniki:
ambition - ambicja/pragnienie
ashes - prochy
aspiration - aspiracja/dążęnie
awakening - obudzenie/uświadomienie
cliche - truimz/banał/frazes
conscience - sumienie
consciousness - świadomość
consternation - konsternacja
demeanor - postawa/postępowanie
notion - myśl/pojęcie
passage - uchwalenie ustawy
reconciling - pojednanie się
reminding - przypominanie
spectre - duch/widmo
tin - puszka

czasowniki:
attain - zdobywać/realizować/osiągać
condemn - potępić/piętnować
confess - przyznawać się/wyznawać
crystalise - krystalizować
detail - wyszczególnić
dismay - niepokoić/konsternować
finance - finansować
foreshadow - zapowiadać/zwiastować
obscure - zaciemniać/przesłaniać
stir - poruszyć
revive - odnawiać/wskrzeszać
resonate - rozbrzmieć/odbijać 
witness - doświadczać

przymiotniki:
dire - okropny/przerażający
eventual - ostateczny/końcowy
haunted - nawiedzony/udręczony
life-threatening - zagrażający życiu
magnificent - wspaniały
militant - wojowniczy/walczący
penniless - bez grosza przy duszy
soaring - wysoki/strzelisty
statesmanlike - godny męża stanu
stirring - nastrojowy/ekscytujący
subdued - łagodny/stłumiony

przysłówki:
brilliantly - błyskotliwie/znakomicie
curiously - interesująco/niezwykle
rightly - słusznie

czasowniki złożone:
hint at sth - robić aluzję do czegoś

wyrażenia:
against all odds - pomimo wszystkich przeciwności
in the nick of time - w ostatniej chwili
lay claim to sth - rościć pretensje do czegoś
let alone sth - a co dopiero/nie mówiąc o czymś
live on borrowed time - wciąż utrzymywać się przy życiu
strike up a friendship - zawrzeć przyjaźń