rzeczowniki:
alimony - alimenty
amenities - udogodnienia/wyposażenie
ancestry - pochodzenie/rodowód
armistice - rozejm
avarice - chciwość
carcass - padlina/tusza
decapitation - ścięcie głowy
extortion - wymuszenie/szantaż/wyłudzenie
greed - chciwość/zachłanność
impartiality - bezstronność/obiektywność
impunity - bezkarność
jackal - szakal
mentality - mentalność
mob - tłum/motłoch/banda
oath - przysięga
pageantry - wielka gala
perjury - krzywoprzysięstwo
piety - pobożność/oddanie
replica - kopia/replika
riches - bogactwo
stock - klasa z której się ktoś wywodzi/zapas
testimony - zeznanie
vice - wada/defekt

czasowniki:
amass - akumulować
loiter - marudzić/wałęsać się

przymiotniki:
agreeable - miły/przyjemny
incapacitated - ubezwłasnowolniony
lengthy - przydługi/dłużący się/rozwklekły
long-winded - rozwlekły/nużący
spellbound - oczarowany/urzeczony
tedious - monotonny/żmudny

przysłówki:
abjectly - żałośnie/pokornie
absurdly - nieprawdopodobnie/absurdalnie
avidly - namiętnie/gorliwie
disorderly - bezładny/niechlujny
heartily - serdecznie/z ochotą
invariably - niezmiennie/zawsze
predominantly - głównie/przeważnie
utterly - całkowicie/kompletnie

czasowniki złożone:
cave/gave in to sth - uginać się pod czymś
run over- przelewać się/przekraczać
wind up - zakończyć/skończyć

wyrażenia:
a closed book - zamknięty rozdział
as regards - jeśli chodzi o
at ease - zrelaksowany/spokojny
at odds - w sprzeczności
be down in the dumps - mieć depresję/być w dołku
blow one's top - wpaść w szał/eksplodować
get dusty - kurzyć się/pokrywać się kurzem
have the edge - mieć przewagę
hold all the aces - panować nad sytuacją
ill at ease - skrępowany/zażenowany
in a spot - w tarapatach/trudnej sytuacji
not by a long shot - wcale/nic a nic
on the edge - na krawędzi/skraju
round the bend - szalony/stuknięty
so-so - tak sobie/jako tako
sweat  one's guts out - harować jak wół
to the point - na temat/do rzeczy
turn a deaf ear - puścić coś mimo uszu