rzeczowniki:
hodgepodge - mieszanina/miszmasz
jumbled - bezładna mieszanina/zamęt
pitfall - problem/kłopot
plausibility - prawdopodobieństwo

czasowniki:
bolster - podpierać/wzmocnić
elucidate - objaśniać/naświetlać
forge - tworzyć/podrabiać
instill - wpoić/napawać
reap - zbierać/korzystać
reinforce - popierać/wzmacniać
solidify - krzepnąć/twardnieć
tantalize - zwodzić/łudzić/dręczyć

przymiotniki:
immense - ogromny/olbrzymi
momentous - doniosły/ważny
palpable - wyraźny/zupełny
perplexing - kłopotliwy
prickly - drażliwy/złośliwy
top-notch - pierwszorzędny
well-crafted  - dobrze wykonany

czasowniki złożone:
leave sth out - pominąć coś

wyrażenia:
come in handy - okazać się użytecznym
no-brainer - łatwizna/pestka
pay dividends - procentować
plead the case - bronić sprawy
take sb off guard - zaskoczyć kogoś