rzeczowniki:
glossary - słowniczek

przymiotniki:
dismissive - lekceważący
need-to-know - potrzebny do działania w danej chwili

rzeczowniki złożone:
heated discussion - zażarta dyskusja
last/final word - ostatnie słowo

czasowniki złożone:
back down - ustępować/dać za wygraną/wycofać się
butt in - wtrącać/wcinać się
get sb's back up - denerwować/irytować/drażnić/wkurzać
give sth away - wydawać/zdradzać coś
keep sth to oneself - zachować coś dla siebie
let on to sb - wygadać się komuś
let sb in on sth - wtajemniczyć kogoś w coś
mull sth over - rozwazyć/rozmyślać nad czymś
occur to sb - przyjść komuś do głowy
open up to sth - ośmielić się/zaczać mówić
pick up on sth - zwracać na coś uwagę/zareagowac na coś
take sth in - pojąć/przyswajać coś
win sb over/round to sth - przekonać kogoś/przeciągnąć na swoją stronę

wyrażenia:
at all costs/any cost/price - za wszelką cenę
be at odds with sth - nie zgadzać się/być sprzecznym
beat about the bush - owijać w bawełnę/mówić ogródkami
for the sake of it - po prostu/bez konkretnego celu
get hold of the wrong end of the stick - źle coś zrozumieć
get the picture - zrozumieć sytuację
get to the point - przejśc do sedna sprawy
it makes no odds - nie robi to róznicy
keep/hold one's cards close to one's chest - nie odkrywać kart
keep sb in the dark - utrzymywać kogoś w nieświadomości
keep sb posted - informowac kogoś na bieżąco
miss the point - nie zrozumieć o co chodzi
play devil's advocate - być adwokatem diabła
put/keep sb in the picture - objaśnić komus sytuację
read between the lines - czytać między wierszami