rzeczowniki:
leisure centre - centrum rekreacyjne
partnership - partnerstwo/współudział/spółka osobowa/wspólnota
stock market - giełda papierów wartościowych
unemployment - bezrobocie

czasowniki:
fold - bankrutować/upadać

przymiotniki:
after-sales - posprzedażowy
booming - prosperujący/kwitnący
cut-throat - zaciekły/okrutny

przysłówki:
financially - finansowo
steadily - równomiernie/miarowo/stopniowo/jednostajnie/stale/mocno/pewnie/uważnie/bacznie

wyrażenia:
after-sales service - serwis posprzedażowy/zakupionego sprzętu
annual turnover - roczny obrót
balance the budget - zrównoważyć budżet
cease trading - zamykać interes
cutthroat competition - bezwzględna konkurencja
do/close a deal - podpisać umowę
float a company - wyprowadzić firmę na giełdę/akcje firmy na rynek
go into business - zając się interesami/biznesem
go into a partnership - zawiązać spółkę
go out of business - wypaśćz interesu/przestać działać
go public - rozchodzić się/ujawnić coś publicznie/upubliczniać coś/wejść na giełdę
make a loss - przynosić/wykazywać straty
market forces - siły rynkowe
market research - badania rynku
in a sth way - w jakiś sposób/w jakimś stylu
launch a product - wprowadzić produkt na rynek
put in/make a bid - przedstawić ofertę
rival company - konkurencyjna firma
run a business - prowadzić biznes/firmę
sales figures - wielkość sprzedaży
secret of success - tajemnica powodzenia/sukcesu
sell shares - sprzedawać udziały
set up a business/company - założyć firmę/biznes
stiff/fierce competition - zacięta konkurencja
strike a deal - dobić targu
take on - zatrudniać/przyjmować/nabywać
win a contract - zdobyć/zawrzeć kontrakt