rzeczowniki:
crime - przestępstwo/zbrodnia
look alike - sobowtór/wierna kopia
onlooker/bystander - świadek wydarzenia/przechodzień/obserwator
pupil - uczeń
show - pokaz/wystawa/widowisko
sightseer - turysta/zwiedzający

czasowniki:
beware - uważać/strzec się/wystrzegać
call in - zadzwonić/zameldować się/wpaść do kogoś
overlook - przeoczyć
regard - mieć wzgląd/brać pod uwagę/cenić/szanować
shout - krzyczeć

przymiotniki:
inferior - niższy rangą/gorszy/podwładny

przysłówki
strangely - dziwnie/osobliwie

wyrażenia:
crowd of curious people - tłum ciekawskich ludzi
gather around sth - zebrać się wokoł czegoś
glance at sth - rzucić okiem na coś/przelecieć coś wzrokiem
have a look at sth - spojrzeć na coś
look back on/to sth - wracać do czegoś/wspominać coś
look down on - patrzeć na kogoś z góry/pogardzać kimś
look here - popatrz/zobacz
look out for sb - szukać/wypatrywać kogoś
look sb up - odwiedzić kogoś po dłuższym czasie
look up to sb - patrzeć na kogoś z podziwem/podziwiać kogoś
see eye to eye on sth - zgadzać się na jakiś temt/zgadzać się co do czegoś
see red - wpaść w furię
see sth through - doprowadzić coś do końca
see to sth - dopilnować czegoś/zajmować się czymś
watch for each other - uważać na siebie nawzajem