rzeczowniki:
bounce - odbicie/sprężystość
cast - gips/obsada/forma/odcień
connotation - konotacja/skojarzenie
coverage - zabezpieczenie/ubezpieczenie/polisa/relacja/sprawodzanie/zasięg/uwaga/nagłośnienie
crowd - tłum/paczka
finding - odkrycie/znalezisko/orzeczenie/werdykt
intrusion - wtrącanie się/wejście/napływ/napór/wtargnięcie
plea - apel/wołanie/błaganie/usprawiedliwianie/pretekst/wytłumaczenie/zarzut/skarga
prenuptial agreement/prenup/marriage contract/settlement - intercyza
prying - wyważenie/podważenie/węszenie/wścibianie nosa/wtrącanie się
setback - komplikacja/problem/nawrót/pogorszenie
statement - oświadczenie/komunikat/wypowiedź/twierdzenie
the press - prasa
utmost - kraniec/ostateczna możliwość

czasowniki:
emulate - naśladować/próbować dorównać/emulować
face - stawiać czoła/zmierzać się z czymś/przyjmować/uznawać/radzić sobie
reveal - wyjawiać/ujawniać/odsłaniać

przymiotniki:
deprived - pozbawiony/wyzuty
emotional - emocjonalny/uczuciowy
exemplary - przykładowy/wzorowy/doskonały
unprecedented - bezprecedensowy/niespotykany

wyrażenia:
cast a shadow over sth - rzucać na coś cięń/kłaść się cieniem na coś
cast back - spoglądać wstecz/wracać/cofać się
concurrence of events - zbieg okoliczności
coupled/combined with sth - w połączeniu z czymś
deny sb's right - kwestionować czyjeś prawo
encroach on sth - naruszyć/wkroczyć w
get out - wysiadać/wychodzić/opuścić/uciec/uciekać/wygarniać/wydostawać się
have the edge on/over sb - mieć nad kimś przewagę
interfere with sb - wpłwać na kogoś
interfere with sth - kolidować z czymś
keep sth alive - utrzymywać coś przy życiu
look up to sb - patrzeć na kogoś z podziwem/podziwiać kogoś/zapatrywać się w kogoś
one-hit wonder - artysta jednego przeboju
poke one's nose into sth - wsadzać/wtykać nos w coś/interesować się czymś niepotrzebnie
rise to fame/stardom - zdobyć sławę
single sb out - wybierać kogoś/wyróżniać kogoś
stroke of luck/fortune - łut szczęścia
take sb to the cleaners - oskubać kogoś/puścić kogoś z torbami/wystąpić do kogoś o pieniądze
through - na wskroś/przez
the end of the road/line - kres/koniec
under surveillance - pod nadzorem