rzeczowniki:
addiction - uzależnienie/nałóg/narkomania
allegation - insynuacja/zarzut oskarżenie
antidepressant -lek przeciwdepresyjny
blaze - wielki pożar/blask/wybuch
contestant - zawodnik/uczestnik teleturnieju
controversy - kontrowersja
glamour - urok/atrakcyjność/czar
haul - ciągnięcie/holowanie/łup/zdobycz
maverick - indywidualista
navy - marynarka wojenna
infamy - zła sława/hańba
prescription - recepta/zalecenie/nakaz
probe - sonda/dochodzenie/śledztwo
raid - rajd/atak/nalot/napaść
recap - streszczenie/podsumowanie
relapse - nawrót/odnowienie/recydywa
ruin - ruina/brak pieniędzy
sham - oszustwo/przekręt/symulacja
sideline - dodatkowe zajęcie
snort - parsknięcie
stint - służba/kadencja/posada/praca
sweetheart - ukochana/sympatia
toll - żniwa ofiary
upbringing - wychowanie
wrangling - walka/kłótnia/spór

czasowniki:
abuse - nadużywać/wykorzystywać
combat - walczyć/zwalczać
deal - współpracować/prowadzić interesy/handlować narkotykami
embark - wchodzić na pokład
fund - ufundować/finansować
kidnap - porwać/uprowadzić
launch - rozpoczynać/wprowadzić
quiz - wypytywać/egzaminować
re-emerge - pojawiać się ponownie
revive - odnawiać/wskrzeszać
ruin - zrujnować
span - trwać/obejmować/sięgać
stint- żałować/skąpić/ograniczać
wed - poślubić/pobrać się

przymiotniki:
acrimonious - zajadły/burzliwy
amicable - przyjacielski/przyjazny/polubowny
attendant - towarzyszący
axed - ścięty toporem
chequered - w kratę/burzliwy
distinguished - wybitny/znakomity/nieprzeciętny
dogged - uparty/zawzięty/zacięty
draconian - drakoński
dumped - zrzucany/usuwany
embroiled - wplątany w nieporozumienie/zangażowany w konflikt
endemic - endemiczny/rozpowszechniony
ensuing - powstały/wynikły
foiled - udaremniony
glittering - błyskotliwy/świetlany
illustrious - wybitny/znakomity/wspaniały
lucrative - dochodowy/intratny/lukratywny
pear-shaped - w kształcie gruszki

przysłówki:
substantially - znacznie/pokaźnie/zasadniczo
wearing - męczący/denerwujący

rzeczowniki złożone:
cabinet minister - minister
career guidance - doradztwo w zakresie kariery
career prospects - perspektywy zawodowe
career structure - struktura kariery zawodowej
death toll - liczba ofiar śmiertelnych
glamour model - fotomodelka
hit movie - przebój kinowy
kerb-crawling - zaczepianie prostytutek z samochodu
lucky break - fart
sleeping pills - tabletka nasenna
smash hit - przebój/sukces
strong suit - mocna strona/mocny punkt

czasowniki złożone:
carve out - wyrobić sobie/opanować
fall into sth - wpaść w coś
force sb into sth - zmusić kogoś do czegoś
get out of sth - wyjeżdzać skądś/uciec z jakiegoś miejsca/przestać coś robić
shoot sth up - szprycować się czymś
shoot up - wzrosnąć/urosnąć
start out - rozpoczynać/wyruszać
take off - startować/odnieść nagły sukces/nabierać tempa

wyrażenia:
all or nothing - wszystko albo nic
be at one's peak - osiągnąć szczyt
be dealt a bad hand - otrzymać słabe karty
be dogged by sb - być prześladowanym, dręczonym przez kogoś
be keen to do sth - palić się do zrobienia czegoś
bright and early - bladym świtem/wcześnie rano
by half - o połowę
call sb's bluff - zmusić kogoś do pokazania kart
come up trumps - spisać się na medal
embark on a career - rozpoczynać karierę
give or take - plus minus/mniej więcej
go pear-shaped - póść źle/nie po myśli
hold all the aces - panować nad sytuacją
ins and outs - na wylot
make or break - wóz albo przewóz
MBA - Master of Business Administration - tytuł magistra studiów menedżerskich
not playing with a full deck - głupi/ograniczony/szalony
off the rails - postrzelony/ekscentryczny/stuknięty
pick and choose - przebierać/grymasić
play with a full deck - sprawiać wrażenie normalnego
rightly or wrongly - słusznie czy niesłusznie
sb's fair share - taka część, jaka się komuś należała
sink or swim - wóz albo przewóz/być rzuconym na głęboką wodę
sooner or later - prędzej czy później
straight and narrow - na ostatniej drodze
the straight and narrow - prosta droga/żyć uczciwie/moralnie
to and fro - tam i z powrotem/wte i wewte/łażenie
tried and tested - niezawodny/sprawdzony
worth of sth - wartość czegoś/ilość pieniędzy