rzeczowniki:
fraud - oszustwo/oszust/naciągacz
old man - stary
short cut - skrót
write-up recenzja

czasowniki:
baby-sit - zajmować/opiekować się dzieckiem/niańczyć
christen - chrzcić/ochrzcić/nazwać/nadawać imię/zainaugorować/otworzyć
mend - naprawiać/reperować/rekompensować/zdrowieć/łatać/zszywać

przymiotniki:
decent - godziwy/przyzwoity/porządny/miły/cenzuralny/przyzwoity
narrow-minded - ograniczony/o wąskach horyzontach/ciasny
old-fashioned - staromodny/staroświecki/niedzisiejszy/przestarzały
old hat - niemodny
old school - staromodny/starodawny
opposing - przeciwny/wrogi/przeciwstawny
word for word - słowo w słowo
word-perfect - mający doskonałą pamięć

przysłówki:
a plenty of - pod dostatkiem/aż nadto
in press - w druku
independently - samodzielnie/oddzielnie/osobno/niezależnie/bezstronnie/obiektywnie

wyrażenia:
at/on short notice - w krótkim czasie/w ostatniej chwili/bez uprzedzenia
be a chip off the old block - podobny jak kropla wody
be attracted to sb - czuć pociąg do kogoś
be in short supply - brakować/występować w małych ilościach
be short with - rozmawiać z kimś oschle
be taken/caught short - mieć nagłą potrzebę pójścia do toalety
by word of mouth - na słowo/gębę/z ust do ust/pocztą pantoflową/w formie mówionej
chip off the old block - nieodrobne dziecko swoich rodziców
deal with sb - uporać się z kimś/poradzić sobie/mieć z kimś do czynienia
drop out - odpaść/wycofać się/rzucić szkołę/studia
fall short of sb's expectations - nie spełniać czyichś oczekiwań
fall short of sth - nie dorównywać czemuś/być mniejszym niż coś
for short - w zdrobneniu/skrócie
from the word go/outset - od samego początku
give one's word - obiecać/dać swoje słowo
go back on one's word - nie dotrzymać słowa
go out of one's way to do something - zrobić wszystko, co w czyjeść mocy/dołożyć wszelkich starać do zrobienia czegoś/włożyć w coś więcej wysiłku niż zwykle
go short - grać na zniżkę/sprzedawać bez pokrycia
go short of sth - nie mieć czegoś
go your own way - pójść własną drogą/być samodzielnym
have a way with sth - mieć dobry sposób na zrobienie czegoś
have a word with sb - zamienić z kimś słowo
have it both ways - mieć i to, i to/jedno i drugie
have it your own way - niech ci będzie
have/get your own way - robić, co się chce/postępować według swojego widzimisię
have nothing to do with sth - nie mieć z czymś nic wspólnego
have the last word - mieć ostatnie słowo
have/exchange words with sb - kłócić się z kimś
in a word - jednym słowem
in short - krótko mówiąc/w skrócie
in short supply - w niedostatecznej ilości
in the past - dawniej/kiedyś/w przeszłości
last/final word - ostatnie słowo
little/just short of sth - trochę mniej niż coś
keep one's word - dotrzymać obietnicy
make short/light work of sth - szbko się z czymś uporać
mend one's ways - poprawiać się/naprawiać swoje błędy
mend/change your ways - poprawiać swoje zachowanie
mince one's words - owijać w bawełnę
mum's the word/give no words but mum - ani mru mru
old flame - stara miłość/dawna znajmość/znajomość z przeszłości
old fogey/fogy - stary piernik/ramol
old hand - stary wyga morski
plenty/loads of sth - mnóstwo czegoś
run short - kończyć się/wyczerpać/wyczerpywać się
run/be short of sth - wyczerpywać coś/mieć mało czegoś
short cut to sth - droga na skróty do czegoś
take sb's word for it - mieć na coś czyjeś słowo
to the point - na temat/do rzeczy
write sb up - obsmarować kogoś/rozpisywać się o kimś
write sth up - napisać coś wyraźnie/przepisać coś na czysto/sporządzić