rzeczowniki:
adolescence - dojrzewanie
adolescent - młodzieniec
appearance - wygląd/wizerunek
daredevil - śmiałek/ryzykant
dent - wgniecienie
fluctuation - wahanie
longevity - długowieczność/długotrwałość
peer - rówieśnik
pension - emerytura
prosperity - dobrobyt/pomyślność
pursuit - pogoń/dążenie/pościg
setback - kompilacja/problem/niepowodzenie
stride - krok/postęp
teen - nastolatek
toddler - małe dziecko/berbeć
twinge - wyrzut/poczucie/ostry ból/kłucie
wealth - bogactwo/majątek

czasowniki:
amend - poprawiać/korygować/ulepszać
articulate - wyrażać
cherish - pielęgnować/dbać/czcić
dent - podważać/nadszarpywać
desist - wstrzymywać/zaniechać
enliven - ożywiać
oscillate - wahać się/oscylować
rack - torturować/łamać
reassure - utwierdzać/zapewniac/uspokajać
rekindle - ożywiac/zapalać
vouch - oświadczać/potwierdzać/ręczyć

przymiotniki:
abrasive - szorstki/zgryźliwy
adolescent - młodociany/dorastający
advisable - celowy
aging - podstarzały
airy - beztroski/lekkomyślny
boyish - chłopięcy
childlike - dziecinny/dziecięcy
confined - ograniczony
dim - słaby/marny
elderly - starawy/stary
fallible - omylny/zawodny
geriatric - stary i słaby
grown-up - dorosły/dojrzały
grumpy - gderliwy/marudzący
hazy - mglisty/zamglony
humble - pokorny/skromny
immature - niedojrzały/dziecinny
infantile - infantylny/dziecięcy
laid-back - wyluzowany/zrelaksowany
puerile - infantylny/dziecinny
purposeful - celowy/rozmyślny/sensowny
sentimental - sentymentalny
thoughtful - troskliwy
unconditional - bezwarunkowy
undivided - niepodzielny
youthful - młodzieńczy

rzeczowniki złożone:
midlife crisis - kryzys wieku średniego
self-esteem - poczucie własnej wartości
senior moment - skleroza
the breadline - granica ubóstwa/minimum socjalne
undivided attention - całkowita uwaga

czasowniki złożone:
get sb down - zasmucić/zmartwić kogoś
strive for sth - dążyć do czegoś/walczyc o coś
vouch for sth - ręczyć za coś

wyrażenia:
and yet - a jednak
be behind - być w plecy
be in the loop - mieć wiedzę na dany temat/być na biężaco
become a habit - stać się nawykiem
carve a niche - znaleźć dla siebie niszę
come to harm - doznać szkody
fall into the pattern - wpisywać się w schemat
find sth difficult - przychodzić coś komuś z trudnością
get the hang of sth - chwytać coś
go extra mile - poświęcić się bardziej, żeby osiągnąć cel
go through a phase - przechodzić przez okres fascynacji czymś lub kimś
keep abreast of sth - być z czymś na bieżąco
live life to the full - brać z życia garściami
live on the breadline - żyć w nędzy/na granicy ubóstwa
live on the edge - zyć na krawędzi
make amends for sth - wynagrodzić coś/zrekompensować coś
make ends meet - wiązać koniec z końcem
make light of sth - lekceważyc coś/umniejszać znaczenie czegoś
notwithstanding - niezależnie od
rack one's brains - łamać sobie głowę
take sb for granted - nie doceniać kogoś
take sth in one's stride - przyjąć coś bez mrugnięcia okiem
with a bad grace - niechętnie/z łaski