rzeczowniki:
anger - złość/gniew
annoyance - irytacja/rozdrażnienie/przykrość
chatter - trajkot/pisk/gwar
drilling - wiercenie
embarrassment - zażenowanie/wstyd/obciach
eyesight - wzrok
relatives - krewni/bliscy
whistling - gwizdanie

czasowniki:
duck robić unik/dać nura/uchylać się od czegoś
hound - ścigać/prześladować
infuriate - doprowadzić do szału/rozwścieczyć
irritate - drażnić/irytować
outburst - wybuch/przypływ

przymiotniki:
bad-tempered - wybuchowy/szybko irytujący się
crotchety - zrzędliwy/marudny
emotional - uczuciowy
fishy - lipny/naciągany/podejrzany
furious - wściekły/rozwścieczony
galling - irytujący/wkurzający
indignant - oburzony
inundated - zasypany
irate - zagniewany/wzburzony
livid - wściekły
ratty - drażliwy/poirytowany/nerwowy
touchy - drażliwy/przewrażliwiony/delikatny

przysłówki:
square - prosto

rzeczowniki złożone:
black sheep - czarna owca
blazing row - gwałtowna kłotnia
heated argument - gwałtowna kłótnia
lion's share - lwia część
quick temper - temperament/porywczość
report card - świadectwo szkolne

czasowniki złożone:
rabbit on - trajkotać/paplać

wyrażenia:
be as blind as a bat - ślepy jak kret
be cross with sb - być złym na kogoś
be dogged by sb - być prześladowanym przez kogoś
be in no mood for sth - nie być w nastroju na coś
be sick and tired of sth - mieć czegoś po dziurki w nosie
blow one's top - wpaść w szał/eksplodować
drive sb up the wall - doprowadzić kogoś do szału
for donkey's years - od bardzo dawna
get on sb's nerves - działać komuś na nerwy
have a whale of a time - doskonale się bawić
hit the roof - wpaść w szał
like water off a duck's back  - jak po kaczce
throw a tantrum - dostać napadu złości/wpaść we wściekłość
till the cows come home - bez końca/przez bardzo długi czas
up in arms - oburzony/bardzo zdenerwowany
wild goose chase - szukanie wiatru w polu
worm one's way out of sth - wykręcać się przed zrobieniem czegoś