rzeczowniki:
ailment - choroba/dolegliwość/niedomaganie
anxiety - niepokój/obawa/lęk
attaining - osiąganie/osiągnięcie
authorities - władze
bliss - rozkosz/szczęście
contributing - wnoszenie/przyczynianie się
depression - przygnębienie
disorder - zaburzenia
distress - ból/cierpienie/rozpacz/nędza
fatique - zmęczenie/znużenie
inducing - skłanianie/nakłanianie/wywoływanie
insomnia/sleeplessness - bezsenność
occurence - zdarzenie/wypadek/występowanie
operate - operować/działać
overworking - przemęczenie/przepracowanie się
powder - proszek/puder
relief - ulega/ukojenie/złagodzenie/wsparcie/pomoc
scarcity - brak/niedobór/niedostatek
spinning - obracanie się/kręcenie się/wirowanie
surroundings - otoczenie/okolica
tablet - tabletka
tiredness - zmęczenie/znużenie
tossing - rzucanie/podrzucanie/miotanie
underpass - przejśćie podziemne
wriggling - kręcenie się/wiercenie się/wyginanie

czasowniki:
affect - oddziaływać na/mieć wpływ na
afflict - dotykać/dręczyć/gnębić/dokuczać
combat - walczyć/zwalczać
compel - zmuszać/wzbudzać
conjure - wywołać/wyczarować/zaklinać/błagać
detect - dostrzegać/zauważać/wykrywać
disparage - ubliżać
endure - znosić/cierpieć/tolerować
enforce - wprowadzać w życie/narzucać
entail - wiązać się z czymś/pociągnąć za sobą/przekazywać jako ordynację
exact - wymagać/wymuszać
exert - okazywać/wywierać/wytężyć
expose - odkrywać/ujawniać/narazać
function - funkcjonować
invalidate - unieważniać
originate - zapoczątkować/dawać początek/wymyślać/powstawać
perform - występować/dokonywać/wykonywać
process - przetwarzać/rozpatrywać
proclaim - obwieszczać/ogłaszać
prove - udowadniać/okazywać się
recuperate - odzyskiwać/wracać do zdrowia
regenerate - odnawiać/odradzać/regenerować się/odrastać
restore - przywrócić
resume - wznawiać/powracać
retrieve - odzyskać/oznaleźć/naprawić/uzdrowić
revive - odnawiać/wskrzeszać/zdrowieć/odżyć
substantiate - popierać dowodami/uzasadniać
undergo - poddawać się/odbywać/ulegać
underlie - być podstawą/znajdować się pod
undertake - podjąć/przedsięwziąć

przymiotniki:
chemical - chemiczny
conscious - świadomy/przytomny
distressing - przygnębiający/smutny/niepokojący/alarmujący
exacting - wymagający/rygorystyczny
medical - medyczny/lekarski
nocturnal - nocny
sleepless - bezsenny
unfavorable - niekorzystny/niesprzyjający
worrying - niepokojący

wyrażenia:
be few and far between - występować w małej ilości
conjure up - przywoływać
consequently - wskutek tego/w rezultacie
even though - pomimo że/chociaż
few and far between - rzadko/nieczęsto
great deal of sth - wielka ilość czegoś
in full - w pełni/w całości
in question - wspomniany/wątpliwy
no wonder - nic dziwnego, że
sleep disorder - zaburzenia snu
sleeping pill - tabletka nasenna
sleepless night - bezsenna noc
turn in - iść spać
yet - ale/mimo to